**********************
* S *   ** **     *  *
* *   *       *** * **
* * *  **  ****   * **
*** ******    *** *  *
*          **  **    *
***** ******   ***** *
*         *******  * *
*********       **   *
*   *         **** ***
**  ****** **   ** ***
*** ***  ****** ******
*   *   ** **     *   
* *   *       *** * **
* * *  **  ****   * **
*** ******    *** *  *
*          **  **    *
***** ******   ***** *
*     *   *******  * *
* *******  **    *   *
*                * ***
**********************
