**********************
*   *   ** **     *   
* *   *       *** * **
* * *  **  ****   * **
*** ******    *** *  *
*          **  **    *
***** ******   ***** *
*     *   *******  * *
* *******      S *   *
*                * ***
****************** ***
